 R 1920 1080
 NO ./path_to_the_north_texture
 SO ./path_to_the_south_texture
 WE ./path_to_the_west_texture
 EA ./path_to_the_east_texture
 S ./path_to_the_sprite_texture
 F 220,100,0
 C 225,30,0

                    11
                   10011
                    10001
                   110001
                  1010001
                 1000101
                 10001001
                 1020001
                  1010011
                 110111101
                10001 1100111
               100201100000001
              1020000000011101
               110001000011001
                1001 11001101
                 101 1101 1001
                  1110000100021
                 10000010000001
                 1010101000001 11
                 10000000000011001
                1001100000000000001
                100000000010000011
                 111000000000001
                    111100000001  1
                        1000001 1101
                         100001101001
                          10011100001
                          10000020001
                         100010000001
                         100000S00001
                          1111111111
