 R 1920 1080
 NO ./path_to_the_north_texture
 SO ./path_to_the_south_texture
 WE ./path_to_the_west_texture
 EA ./path_to_the_east_texture
 S ./path_to_the_sprite_texture
 F 220,100,0
 C 225,30,0


                                                                            1
                                                                           101
                                                                           1001 1111
                                                                            100100001
                                                                  1         10000100011
                                                                 1011       100001000001
                                                                 10001      1E0000000001
                                                                 100001  11110000000001
                                                                  10000110000000000001
                                                                  10000110000000000001
                                                                   1100000000000000001
                                                                   100000000000000001
                                                                  11111000000000000001
                                                                 100110000000000000001
                                                                1000010000000000000001
                                                                1000000000000000000001
                                                               100000000000000000000001
                                                         111  10000000000000000001000011111
                                                        100011000000000000000000110000000001
                                                    1111100000000000000000000000100000000001
                                                   10000000000000000000000000000000011110001
                                                  110011001000000000000000000000000000110001
                                                 10101 1000111000000000000000000000001  111
                                                 10001 1000110000000000000000000000001
                                                10001  1001 1000000000000000000000101
                                                10111111011  1100000000000000000001001
                                               10000000001011000000000000000000100000111
                                               100000000010000001100000000000000000000001
                                                10000000010110000000000000000000000000001   11111111
                                                 1111110010100000000000000000100000000001  1000000001
                                                   100100000000000000001000101100100000001 1010001001
                                                    10000000000000000001111 1  100000000011000111100011
                                                  1110000000000000001001        11000000010001 100000001
                          11                    110010000000101011000001        10000000110011110001000111  111
                         1001                  1010000000000100001000001       100100001110000000000000000110001
                         10001 1              1000000000000000000010011  1111 111000000000000000010000000011001
                 11     1000001011           11000000000000000000011111 100001000000010000000000000000000000001
                100111  10100000001         10000000000000000000011000010000000001000000000000000000000000000001
                10000011000000000011         100000000000000000000000000001000000100000000000000010000000000111
                100100110000000000001        10000000000000000000000000000111110000000000000000000000000000001
                100110000000000111101      1110000000000001010000001000011    10000000000000000000000000000001
                 100110110000000000001    100110000000000000000000010001       100000000000000000000000100011
                 10000000001100001001    10000100000000000000001111 1011  1 11 100010000000000000000000000001
                  1111000000000000000111110000111101111000000001    10101101001100110000000000000000000010001
         111        1001110000111000000000010111000001 10001011     10000000000011100000000000000000000000001     1
   11111100011    11101  10111 10000000001000000010101  111 1       10100000000000000000000000000000000001001   1101
  100000001000111100001   1    10000001111000000110001               1 111111110100000000000000100000000011011 1000011 11
  10011111 10000000111         100000011 10010001 111 1                        1100000000000000000000000011000110000001001 1
   101 1    111001001          101000000100000001    101      1111               10000001111000000000000000000000000000000101
   1011011     11 11           10100000000000111   11001  1  100001               100011  10000000000000000000000000001000001
   100000011                   101100010010000111 1000011101 1000001              10110011000000000000000000000100101110000001
 111111000001                  10000000000000000010000010000110011001              1 10011001100000000000000001 11100110100001
1000011100001                   111000000000000000000000000001000101                  100000010000000000000000011100000000001
 111000000000111                110000000000001111110000000000000001                  1000000000000000000000000000000000000001
  1001100000000011             10000000000000001    111110010001001                  10011000000000000000000000001100000001001
   1001100000000001           100000011000100001111      110001101                   1000000000000000000000000000100001000011
    10000000000001         1110000000110000000002001   1 1000011001                  100000000000010000000000000000001 1111
    10000000000001        100000000111000100000000011 1011000000001                   100000000000100000000010000000001
     1100000000001        100100001  11000000000000001100100000111                    10000000000000100001000011100011
      1000000011011      10000000011100000000110000000000101101                       10000000000001100111000001 111
      10000000000001     1000000000000000000011000000001000001                       10000000011011 1001 1000001
      100000000000001   100000000000100000000000021000011000001                     1100000000011    11   11111
    11000000000000001   100000000000000000000000100000000000001                    100000000001
 111011100000000000011  100000000000100010000001100000000000001                    100000110001
10000000000000000010101 10100000000000000000001101000000000001                    1100000000001
10010000000000200000001 10000000000000000011001000000000000001                   1000000000001
10000000000000000000001  100000011000110000000000000020000011                   100000000000001
100000000000000000000011 10010001000100101111100011001110001                     10000000011111
10000000000000000001000011000010000110010111000011101   1001                      10000000000001
10000000000000000000000000000000000000010000001100001    11                        1000000000001
1000000000000000000000000000000000110000000000000101                               100001001111
1000000000000000000000000000000000000000001000000001111                             10000001
10000010000000000000000000000001011000000010000001000001                            10000001
10000000000000000000000000000011000000000000000001111001                             1000001
1000000000000000000000000000000100000000000000000000001                               10111
100000000000000000000000000000011000000000110000000011                                 1
10000200000002000000000000111111000010000110010000001
100000000000000000000000001     100110001 1000000011
1000000000000000000000000011    10011011   11111001
10000000000000000000000000001    101 1          11
10000000000000000000000000001     1
100000000000000000000000000001
10000000000000000000000000001
1000000000000000000000000011
100000000000000000000000001
 11111111111111111111111111
